G,G,G,G,G
G,R,G,G,G
G,R,G,G,E
G,R,R,R,G
G,G,G,G,P