G,G,G,G,G,G
G,R,E,E,G,G
G,R,G,G,R,G
G,R,G,G,G,G
G,R,R,R,G,G
G,G,G,G,G,P